D D D D D D D D D D D D D D D D D D D D
D O O O O O O O O O O O O O O O O O O D
D O O O O O O O O O O O O O O O O O O D
D O O O O O O O O O O O O O O O O O O D
D O O O O O O O O O O O O O O O O O O D
D O O O O O O O O O O O O O O O O O O D
D O O O O O O O O O O O O O O O O O O D
D O O O O O O O O W W O O O O O O O O D
D O O O O O O D D D D D O O O O O O O D
D O O O O O O D D D D D O O O O O O O D
D O w O O O O D D D D D O O O O O O O D
D O O O O O O D D D D D O O O O O O O D
D O O O O O O O W W O O O O O O O O O D
D O O O O O O O O O O O O O O O O O O D
D O O O O O O O O O O O O O O O O O O D
D O O O O O O O O O O O O O O O O O O D
D O O O O O O O O O O O O O O O O O O D
D O O O O O O O O O O O O O O O O d O D
D O O O O O O O O O O O O O O O O O O D
D D D D D D D D D D D D D D D D D D D D
